1111111
1E10111
10P01C1
1111111