11111
1PC11
10111
11E11
11111
