1111111
1CP1111
1010111
10E1111
1111111
