1111111111111
1011C0C000001
1000100010001
101000CP11C01
100100C000001
10000C01E0001
10000C0000001
1001101001101
10000C0000001
1111111111111
