1111111111111
10000C0000001
1000000010001
10000CP000001
100000C000001
10000C00E0001
10000C0000001
10000C0000001
10000C0000001
1111111111111