11111111111111111111111111111111
1E00000000100000000000C000000111
11111111011110111111111111110111
11110111011111111111111111110111
11000000000100000100111111110111
11011111111111000100000111110111
11011111111110011111111111110111
11011111100001000000000000110111
11011111101111111111011110000001
11011111101111110000011110110111
11011111101111110111011110110111
11011111100000110111011110000001
11000001111110110111011110111101
10011100000000110111011110111101
11011101111111110111011110000001
110000000000000000000000000000P1
11111111111111111111111111111111