11111111111111111111111111111111
1E00000000100000000000C0000001C1
111111110111111C1111111111110101
11110111011111111100000000010101
1100000001C000000101111111010101
11011111111111011101111111C10101
11011111111111011101111111110101
1101111110000001C000000000110101
11010000001111111111011110100001
11010111101111110000011110110111
11010000101111110111011110110111
1101111C100000110111011110100001
11000001111110110111011110110101
1C01110000000011C1000111100001C1
11011111111111111111011111111111
110000000000000000000000000000P1
11111111111111111111111111111111