1111111111111
10C10C0001001
100001C111001
1P0011E000001
1111111111111