1111111111111
10C10C0001P01
100001C111001
10011E0000011
1111111111111