11111111
1000EC01
1P100001
11111111